0 0 0 0 0 0 0 0 0 0 0 0 0 0 0 0 0 0 0 0 0 0 0 0 0
0 0 0 0 0 0 0 0 0 0 0 0 0 0 0 0 0 0 0 0 0 0 0 0 0
0 0 0 0 0 0 0 0 0 0 0 0 0 0 0 0 0 0 0 0 0 0 0 0 0
D D D D D D D D D D D 0 0 0 D D D D D D D D D D D
D 0 0 0 0 0 0 0 0 0 D 0 0 0 D 0 0 0 0 0 0 0 0 0 D
D 0 0 0 0 0 0 0 0 0 D 0 0 0 D 0 0 0 0 0 0 0 0 0 D
D 0 0 0 0 0 0 0 0 0 D 0 0 0 D R R R R R R R R R D
D 0 0 0 0 0 0 0 0 0 D 0 0 0 D R R R R R R R R R D
D 0 0 0 0 0 0 0 0 0 D 0 0 0 D G R R R R R R R R D
D D D D D D D D D D D 0 0 0 D D D D D D 0 0 D D D
D 0 0 0 0 0 0 0 D 0 0 0 0 0 0 0 D 0 0 0 0 0 0 0 D
D 0 0 R 0 0 0 0 3 0 0 0 0 0 0 0 1 0 0 0 X 0 0 0 D
D D D D D D D D D D D 0 0 0 D D D D D D D D D 0 D
D 0 0 0 0 0 0 0 0 0 D P 0 0 D 0 0 D 0 0 0 0 0 0 D
D 0 0 0 0 0 0 0 0 0 D 0 0 0 D 0 0 $ 0 0 0 0 0 0 D
D D D D D D D D D D D 0 0 0 D 0 0 D D D D D D D D
D 0 0 0 0 0 0 0 0 0 0 0 0 0 D 0 0 0 0 0 0 0 0 0 0
D 0 0 0 0 B 0 0 0 0 0 0 X 0 D 0 0 0 0 0 0 0 0 0 0
D D D D D D D D D D D D D D D D D D D D D D D D D