0 0 0 0 0 0 0 0 0 0 0 0 0 0 0 0 0 0 0 0 0 0 0 0 0
0 0 0 0 0 0 0 0 0 0 0 0 0 0 0 0 0 0 0 0 0 0 0 0 0
0 0 0 0 0 0 0 0 0 0 0 0 0 0 0 0 0 0 0 0 0 0 0 0 0
0 0 0 0 0 0 0 0 0 0 0 0 0 0 0 0 0 0 0 0 0 0 0 0 0
0 0 0 0 0 0 0 0 0 0 0 0 0 0 0 D D D D D D D D D D
D 0 0 0 0 0 0 0 0 0 0 0 0 0 0 D 0 0 0 0 0 0 0 N D
D 0 0 0 0 0 0 0 0 0 0 0 0 0 0 D 0 0 0 0 0 0 0 0 D
D D D D D D D D D D D D D D D D 0 0 0 0 0 D 0 0 D
D 0 0 0 0 0 D 0 0 0 0 0 0 0 0 D 0 0 0 0 0 D 0 0 D
D 0 0 0 0 0 D 0 0 0 0 0 0 0 0 D 0 0 0 0 0 D 0 0 D
D 0 0 0 0 0 D 0 0 0 0 0 0 0 0 D 0 0 0 0 0 D 0 0 D
D 0 0 R 0 0 D 0 0 0 0 0 0 0 0 D 0 0 0 0 0 D 0 0 D
D 0 0 0 0 0 ! R 0 0 0 0 P 0 0 $ 0 0 0 0 P ! 0 W D
D D D D D D D D 0 0 D D D D D D D 0 0 D D D D D D
D 0 0 0 0 0 0 D 0 0 0 D 0 0 0 0 0 0 0 0 0 0 0 0 0
D G R G R 0 0 D 0 0 0 D 0 0 0 0 0 0 0 0 0 0 0 0 0
D 0 0 0 0 0 0 D 0 0 0 D 0 0 0 0 0 0 0 0 0 0 0 0 0
D 0 0 0 0 0 0 $ 0 W 0 D 0 R 0 0 0 0 Z 0 0 0 0 0 0
D D D D D D D D D D D D D D D D D D D D D D D D D