0 0 0 0 0 0 0 0 0 0 0 0 0 0 0 0 0 0 0 0 0 0 0 0 0
0 0 0 0 0 0 0 0 0 0 0 0 0 0 0 0 0 0 0 0 0 0 0 0 0
0 0 0 0 0 0 0 0 0 0 0 0 0 0 0 0 0 0 0 0 0 0 0 0 0
0 0 0 0 0 0 0 0 0 0 0 0 0 0 0 0 0 0 0 0 0 0 0 0 0
0 0 0 0 0 0 0 0 0 0 0 0 0 0 0 0 0 0 0 0 0 0 0 0 0
D 0 0 0 0 0 0 0 0 0 0 0 0 0 0 0 0 0 0 0 0 0 0 0 D
D 0 0 0 D D D D D D D D D D D D D D D D D D D D D
D 0 0 0 0 0 0 0 0 0 0 ^ 0 0 0 0 ^ 0 0 0 0 0 0 0 D
D D D D D D D D D D D D D D D D D D D D D 0 0 0 D
D 0 0 0 0 0 0 0 0 ^ 0 0 B P R 0 G 0 ^ 0 0 0 0 0 D
D 0 0 0 D D D D D D D D D D D D D D D D D D D D D
D 0 0 0 0 0 0 0 0 0 6 0 0 0 0 0 0 0 0 0 0 0 0 0 D
D D D D D D D D D D D D D D D D D D D D D 0 0 0 D
D 0 0 0 0 0 G 0 $ 0 4 0 G 0 ^ 0 0 0 0 0 0 0 0 P D
D 0 0 0 D D D D D D D D D D D D D D D D D D D D D
D 0 0 0 0 0 ! 0 R 0 P 0 # 0 B 0 % 0 B 0 0 0 0 0 D
D D D D D D D D D D D D D D D D D D D D D 0 0 0 D
D 0 0 B 0 # 0 R 0 % 0 P 0 G 0 @ 0 0 0 0 0 0 0 0 D
D D D D D D D D D D D D D D D D D D D D D D D D D