0 0 0 0 0 0 0 0 0 0 0 0 0 0 0 0 0 0 0 0 0 0 0 0 0
0 0 0 0 0 0 0 0 0 0 0 0 0 0 0 0 0 0 0 0 0 0 0 0 0
0 0 0 0 0 0 0 0 0 0 0 0 0 0 0 0 0 0 0 0 0 0 0 0 0
0 0 0 0 0 0 0 0 0 0 0 0 0 0 0 0 0 0 0 0 0 0 0 0 0
D D D D D D D D D D D D D D D D D D D D D D D D D
D 0 0 0 0 0 0 0 0 0 0 0 0 0 0 0 D 0 0 0 0 0 0 0 D
D 0 0 0 0 0 0 0 0 0 0 0 0 0 0 0 D 0 0 0 0 0 0 0 D
D 0 0 0 0 0 0 0 0 0 0 0 0 0 0 0 D 0 0 0 0 R B 0 D
D 0 0 P 0 0 0 0 0 0 0 0 0 0 0 0 1 0 0 0 0 0 0 0 D
D 0 0 D D D D D D D D 0 0 D D D D D D D D 0 0 D D
D 0 0 0 D P 0 0 0 0 D 0 0 0 D 0 0 0 0 0 D 0 0 0 0
D 0 0 0 D 0 0 0 0 0 D N 0 0 D 0 0 0 0 0 D 0 0 0 0
D 0 0 0 D 0 0 0 0 0 D 0 0 0 D 0 0 0 0 0 D D 0 0 0
D 0 V 0 % 0 0 0 0 0 !0 Z 0 D 0 0 0 0 0 0 0 0 0 0
D D D D D D 0 0 0 D D D D D D 0 0 0 0 0 0 0 0 0 0
D 0 R 0 0 D 0 0 0 D 0 0 0 0 D 0 0 0 0 0 0 0 0 0 0
D 0 0 0 0 D 0 0 0 D 0 0 B 0 D 0 0 0 0 0 0 0 0 0 0
D 0 0 0 0 !0 Z 0 1 0 0 0 0 D 0 0 0 0 0 0 0 V 0 0
D D D D D D D D D D D D D D D D D D D D D D D D D