D 0 0 D 0 0 0 0 0 0 0 0 0 0 0 0 0 0 0 0 0 0 0 0 0
D 0 0 D 0 0 0 0 0 0 0 0 0 0 0 0 0 0 0 0 0 0 0 0 0
D B G D 0 0 0 0 0 0 0 0 0 0 0 0 0 0 0 0 0 0 0 0 0
D S S D 0 0 0 0 0 0 0 0 0 0 0 0 0 0 0 0 0 0 0 0 0
D S S D 0 0 0 0 0 0 0 0 0 0 0 0 0 0 0 0 0 0 0 0 0
D S S D 0 0 0 0 0 0 0 0 0 0 0 0 0 0 0 0 0 0 0 0 0
D S S D 0 0 0 0 0 0 0 0 0 0 0 0 0 0 0 0 0 0 0 0 0
D S S D 0 0 0 0 0 0 0 0 0 0 0 0 0 0 0 0 0 0 0 0 0
D S S D 0 0 0 0 0 0 0 0 0 0 0 0 0 0 0 0 0 0 0 0 0
D S S D D D 0 D D 0 0 D D D D 0 0 0 0 0 0 0 0 0 0
D V S S R S S S S S B 3 S N D 0 0 0 0 0 0 0 0 0 0
D D D D D D D D D S D D D D D 0 0 0 0 0 0 0 0 0 D
D 0 0 0 0 0 0 0 D S D 0 0 0 0 0 0 0 0 0 0 0 0 0 D
D 0 0 0 0 0 0 0 D S D 0 0 0 0 0 0 0 0 0 0 0 0 0 D
D 0 0 0 0 0 0 0 D S D 0 0 0 0 0 0 0 0 0 0 0 0 0 D
D 0 0 0 0 0 0 0 D S D 0 0 0 0 0 0 0 0 0 0 0 0 0 D
D D D D D D D D D S D D D D D D D D D D D D D D D
D S S R S ! S G S W S S S S S S S S S S S S S S S
D D D D D D D D D D D D D D D D D D D D D D D D D