0 0 0 0 0 0 0 0 0 0 0 0 0 0 0 0 0 0 0 0 0 0 0 0 0
0 0 0 0 0 0 0 0 0 0 0 0 0 0 0 0 0 0 0 0 0 0 0 0 0
0 0 0 0 0 0 0 0 0 0 0 0 0 0 0 0 0 0 0 0 0 0 0 0 0
0 0 0 0 0 0 0 0 0 0 0 0 0 0 0 0 0 0 0 0 0 0 0 0 0
0 S S S S S S S S S S S S S S S S S S S S S S S S
D S S S S S S S S S S S S S S S S S S S S S S S D
D S S S D D D D D D D D D D D D D D D D D D D D D
D S S S S S S S S S S ^ S S S S ^ S S S S S S S D
D D D D D D D D D D D D D D D D D D D D D S S S D
D S S S S S S S S ^ S S B P R S G S ^ S S S S S D
D S S S D D D D D D D D D D D D D D D D D D D D D
D S S S S S S S S S 6 S S S S S S S S S S S S S D
D D D D D D D D D D D D D D D D D D D D D S S S D
D S S S S S G S $ S 4 S G S ^ S S S S S S S S P D
D S S S D D D D D D D D D D D D D D D D D D D D D
D S S S S S ! S R S P S # S B S % S B S S S S S D
D D D D D D D D D D D D D D D D D D D D D S S S D
D S S B S # S R S % S P S G S @ S S S S S S S S D
D D D D D D D D D D D D D D D D D D D D D D D D D