D 0 0 D 0 0 0 0 0 0 0 0 0 0 0 0 0 0 0 0 0 0 0 0 0
D 0 0 D 0 0 0 0 0 0 0 0 0 0 0 0 0 0 0 0 0 0 0 0 0
D B G D 0 0 0 0 0 0 0 0 0 0 0 0 0 0 0 0 0 0 0 0 0
D 0 0 D 0 0 0 0 0 0 0 0 0 0 0 0 0 0 0 0 0 0 0 0 0
D 0 0 D 0 0 0 0 0 0 0 0 0 0 0 0 0 0 0 0 0 0 0 0 0
D 0 0 D 0 0 0 0 0 0 0 0 0 0 0 0 0 0 0 0 0 0 0 0 0
D 0 0 D 0 0 0 0 0 0 0 0 0 0 0 0 0 0 0 0 0 0 0 0 0
D 0 0 D 0 0 0 0 0 0 0 0 0 0 0 0 0 0 0 0 0 0 0 0 0
D 0 0 D 0 0 0 0 0 0 0 0 0 0 0 0 0 0 0 0 0 0 0 0 0
D 0 0 D D D 0 D D 0 0 D D D D 0 0 0 0 0 0 0 0 0 0
D V 0 0 R 0 0 0 0 0 B # 0 N D 0 0 0 0 0 0 0 0 0 0
D D D D D D D D D 0 D D D D D 0 0 0 0 0 0 0 0 0 D
D 0 0 0 0 0 0 0 D 0 D 0 0 0 0 0 0 0 0 0 0 0 0 0 D
D 0 0 0 0 0 0 0 D 0 D 0 0 0 0 0 0 0 0 0 0 0 0 0 D
D 0 0 0 0 0 0 0 D 0 D 0 0 0 0 0 0 0 0 0 0 0 0 0 D
D 0 0 0 0 0 0 0 D 0 D 0 0 0 0 0 0 0 0 0 0 0 0 0 D
D D D D D D D D D 0 D D D D D D D D D D D D D D D
D 0 0 R 0 1 0 G 0 W 0 0 0 0 0 0 0 0 0 0 0 0 0 0 0
D D D D D D D D D D D D D D D D D D D D D D D D D