■ 0 0 ■ 0 0 0 0 0 0 0 0 0 0 0 0 0 0 0 0 0 0 0 0 0
■ 0 0 ■ 0 0 0 0 0 0 0 0 0 0 0 0 0 0 0 0 0 0 0 0 0
■ B G ■ 0 0 0 0 0 0 0 0 0 0 0 0 0 0 0 0 0 0 0 0 0
■ 0 0 ■ 0 0 0 0 0 0 0 0 0 0 0 0 0 0 0 0 0 0 0 0 0
■ 0 0 ■ 0 0 0 0 0 0 0 0 0 0 0 0 0 0 0 0 0 0 0 0 0
■ 0 0 ■ 0 0 0 0 0 0 0 0 0 0 0 0 0 0 0 0 0 0 0 0 0
■ 0 0 ■ 0 0 0 0 0 0 0 0 0 0 0 0 0 0 0 0 0 0 0 0 0
■ 0 0 ■ 0 0 0 0 0 0 0 0 0 0 0 0 0 0 0 0 0 0 0 0 0
■ 0 0 ■ 0 0 0 0 0 0 0 0 0 0 0 0 0 0 0 0 0 0 0 0 0
■ 0 0 ■ ■ ■ 0 ■ ■ 0 0 ■ ■ ■ ■ 0 0 0 0 0 0 0 0 0 0
■ V 0 0 R 0 0 0 0 0 B # 0 N ■ 0 0 0 0 0 0 0 0 0 0
■ ■ ■ ■ ■ ■ ■ ■ ■ 0 ■ ■ ■ ■ ■ 0 0 0 0 0 0 0 0 0 ■
■ 0 0 0 0 0 0 0 ■ 0 ■ 0 0 0 0 0 0 0 0 0 0 0 0 0 ■
■ 0 0 0 0 0 0 0 ■ 0 ■ 0 0 0 0 0 0 0 0 0 0 0 0 0 ■
■ 0 0 0 0 0 0 0 ■ 0 ■ 0 0 0 0 0 0 0 0 0 0 0 0 0 ■
■ 0 0 0 0 0 0 0 ■ 0 ■ 0 0 0 0 0 0 0 0 0 0 0 0 0 ■
■ ■ ■ ■ ■ ■ ■ ■ ■ 0 ■ ■ ■ ■ ■ ■ ■ ■ ■ ■ ■ ■ ■ ■ ■
■ 0 0 R 0 1 0 G 0 W 0 0 0 0 0 0 0 0 0 0 0 0 0 0 0
■ ■ ■ ■ ■ ■ ■ ■ ■ ■ ■ ■ ■ ■ ■ ■ ■ ■ ■ ■ ■ ■ ■ ■ ■